"filename", "language", "Dart", "comment", "blank", "total"
"/Users/kanema/Documents/Kanema/projects/kanemaonline/lib/api/auth_api.dart", "Dart", 93, 18, 16, 127
"/Users/kanema/Documents/Kanema/projects/kanemaonline/lib/api/live_events_api.dart", "Dart", 47, 0, 7, 54
"/Users/kanema/Documents/Kanema/projects/kanemaonline/lib/api/tvs_api.dart", "Dart", 47, 0, 7, 54
"/Users/kanema/Documents/Kanema/projects/kanemaonline/lib/api/vods_api.dart", "Dart", 54, 0, 8, 62
"/Users/kanema/Documents/Kanema/projects/kanemaonline/lib/data/countries.dart", "Dart", 1478, 0, 1, 1479
"/Users/kanema/Documents/Kanema/projects/kanemaonline/lib/data/trends.dart", "Dart", 1278, 0, 1, 1279
"/Users/kanema/Documents/Kanema/projects/kanemaonline/lib/helpers/constants/colors.dart", "Dart", 8, 0, 3, 11
"/Users/kanema/Documents/Kanema/projects/kanemaonline/lib/helpers/constants/input_decorations.dart", "Dart", 29, 0, 3, 32
"/Users/kanema/Documents/Kanema/projects/kanemaonline/lib/main.dart", "Dart", 75, 1, 7, 83
"/Users/kanema/Documents/Kanema/projects/kanemaonline/lib/providers/auth_provider.dart", "Dart", 70, 40, 25, 135
"/Users/kanema/Documents/Kanema/projects/kanemaonline/lib/providers/live_events_provider.dart", "Dart", 18, 0, 7, 25
"/Users/kanema/Documents/Kanema/projects/kanemaonline/lib/providers/tvs_provider.dart", "Dart", 25, 0, 9, 34
"/Users/kanema/Documents/Kanema/projects/kanemaonline/lib/providers/vods_provider.dart", "Dart", 24, 0, 9, 33
"/Users/kanema/Documents/Kanema/projects/kanemaonline/lib/screens/auth/choose_country.dart", "Dart", 148, 1, 8, 157
"/Users/kanema/Documents/Kanema/projects/kanemaonline/lib/screens/auth/forgot_password.dart", "Dart", 104, 0, 7, 111
"/Users/kanema/Documents/Kanema/projects/kanemaonline/lib/screens/auth/login.dart", "Dart", 220, 2, 13, 235
"/Users/kanema/Documents/Kanema/projects/kanemaonline/lib/screens/auth/register.dart", "Dart", 200, 3, 8, 211
"/Users/kanema/Documents/Kanema/projects/kanemaonline/lib/screens/details_pages/live_event_details.dart", "Dart", 0, 0, 1, 1
"/Users/kanema/Documents/Kanema/projects/kanemaonline/lib/screens/details_pages/live_tv_details.dart", "Dart", 0, 0, 1, 1
"/Users/kanema/Documents/Kanema/projects/kanemaonline/lib/screens/details_pages/single_video_details.dart", "Dart", 209, 0, 9, 218
"/Users/kanema/Documents/Kanema/projects/kanemaonline/lib/screens/details_pages/tv_show_details.dart", "Dart", 12, 0, 4, 16
"/Users/kanema/Documents/Kanema/projects/kanemaonline/lib/screens/generics/choose_country_popup.dart", "Dart", 125, 0, 6, 131
"/Users/kanema/Documents/Kanema/projects/kanemaonline/lib/screens/generics/landing.dart", "Dart", 114, 0, 4, 118
"/Users/kanema/Documents/Kanema/projects/kanemaonline/lib/screens/home/homescreen.dart", "Dart", 222, 1, 10, 233
"/Users/kanema/Documents/Kanema/projects/kanemaonline/lib/screens/live_events/all_events_search_screen.dart", "Dart", 70, 0, 4, 74
"/Users/kanema/Documents/Kanema/projects/kanemaonline/lib/screens/live_events/live_events_screens.dart", "Dart", 153, 0, 7, 160
"/Users/kanema/Documents/Kanema/projects/kanemaonline/lib/screens/livetv/livetv_screen.dart", "Dart", 178, 2, 5, 185
"/Users/kanema/Documents/Kanema/projects/kanemaonline/lib/screens/players/events_player.dart", "Dart", 281, 11, 28, 320
"/Users/kanema/Documents/Kanema/projects/kanemaonline/lib/screens/players/live_tvs_player.dart", "Dart", 432, 58, 33, 523
"/Users/kanema/Documents/Kanema/projects/kanemaonline/lib/screens/players/video_player.dart", "Dart", 636, 22, 38, 696
"/Users/kanema/Documents/Kanema/projects/kanemaonline/lib/screens/profile/profile_screen.dart", "Dart", 200, 1, 13, 214
"/Users/kanema/Documents/Kanema/projects/kanemaonline/lib/screens/profile_screens/account/account_screen.dart", "Dart", 34, 0, 4, 38
"/Users/kanema/Documents/Kanema/projects/kanemaonline/lib/screens/profile_screens/help/help_screen.dart", "Dart", 12, 0, 4, 16
"/Users/kanema/Documents/Kanema/projects/kanemaonline/lib/screens/profile_screens/subscriptions/subscription_screen.dart", "Dart", 12, 0, 4, 16
"/Users/kanema/Documents/Kanema/projects/kanemaonline/lib/screens/root_app.dart", "Dart", 116, 0, 7, 123
"/Users/kanema/Documents/Kanema/projects/kanemaonline/lib/screens/screens.dart", "Dart", 14, 5, 5, 24
"/Users/kanema/Documents/Kanema/projects/kanemaonline/lib/screens/videos/all_videos_search_screen.dart", "Dart", 115, 0, 9, 124
"/Users/kanema/Documents/Kanema/projects/kanemaonline/lib/screens/videos/videos_screen.dart", "Dart", 154, 8, 11, 173
"/Users/kanema/Documents/Kanema/projects/kanemaonline/lib/services/auth_service.dart", "Dart", 9, 0, 2, 11
"/Users/kanema/Documents/Kanema/projects/kanemaonline/lib/services/database_service.dart", "Dart", 1, 0, 1, 2
"/Users/kanema/Documents/Kanema/projects/kanemaonline/lib/widgets/all_media_search_bar.dart", "Dart", 35, 0, 3, 38
"/Users/kanema/Documents/Kanema/projects/kanemaonline/lib/widgets/bot_toasts.dart", "Dart", 31, 0, 2, 33
"/Users/kanema/Documents/Kanema/projects/kanemaonline/lib/widgets/button.dart", "Dart", 37, 0, 3, 40
"/Users/kanema/Documents/Kanema/projects/kanemaonline/lib/widgets/error_widget.dart", "Dart", 73, 0, 3, 76
"/Users/kanema/Documents/Kanema/projects/kanemaonline/lib/widgets/hero_search_appbar.dart", "Dart", 34, 0, 2, 36
"/Users/kanema/Documents/Kanema/projects/kanemaonline/lib/widgets/hero_widget.dart", "Dart", 158, 7, 3, 168
"/Users/kanema/Documents/Kanema/projects/kanemaonline/lib/widgets/scaffold_wrapper.dart", "Dart", 44, 7, 7, 58
"/Users/kanema/Documents/Kanema/projects/kanemaonline/lib/widgets/trending_list_sm_widget.dart", "Dart", 58, 0, 3, 61
"/Users/kanema/Documents/Kanema/projects/kanemaonline/lib/wrapper.dart", "Dart", 30, 16, 7, 53
"Total", "-", 7517, 203, 382, 8102